0100000000000000000000000000000!
0110011110111111100000000000000!
0010010010100000110000000000000!
0010010110100000011000000000000!
0010010100101111001000000000000!
0010010101101001001000000000000!
0011110101001001001100000000000!
0000000101101001000110000000000!
0011111100111001110011111111111!
0010000000000000010000000000000!
0011111111111111110000000000000!
0000000000000000000000000000000!
0000000000000000000000000000000!
0000000000000000000000000000000!
0000000000000000000000000000000!
0000000000000000000000000000000!
0000000000000000000000000000000!
